EA   textures/purplestone.xpm     


R  600  540  


NO  ./textures/mossy.xpm

F  20  ,  250, 70 
C 0 ,  255  ,  255

S  textures/pillar.xpm


SO   textures/pillar.xpm  
  
WE  ./textures/eagle.xpm   


        1111111111111111111111111      
        1000000000110000001000001
        1011000001110000002000001    0
        10010000000000W0001000001
111111111011000001110000002000001  
100000000011000001110111111111111
11110111111111011100000000001011111
11110111111111011101010011111111101    1      0
1100000011010101 100000011111111111
1000000000000000110000001
10000000000000001101010011              0
11000001110101011111000001111
11110001 1110101110111101001100000000000000000000000010000000001
11111111 11111111111111111111111111111

