

R  800   600  

EA    ./purplestone.xpm     

NO ./eagle.xpm    

C 0 ,  255  ,  255

S  ./sanic.xpm

   F 20 , 250 , 70
SO ./north_texture.xpm  
  
WE ./mossy.xpm 


        1111111111111111111111111      
        1000000000110E00000000001
        1011000001110222000000001
        1001000000000000000000001
111111111011000001110000000000001
100000000011000001110111111111111
11110111111111011100000000001
11110111111111011101010011111
1100000011010101110000001
10000000000000001100000011111
10000000000000001101010010001
1100000111010101111100000111
11110001 11101011101111010001
11111111 11111111111111111111