


F  20  ,  250, 70 
C 0 ,  255  ,  255
EA   textures/purplestone.xpm     
R  10 137
NO  ./textures/mossy.xpm
S  textures/sanic.xpm
SO   textures/pillar.xpm  
WE  ./textures/eagle.xpm   

        1111111111111111111111111
        1000000000110000001000001
        10110000011100S0002000001
        1001000000000000021200001    111
111111111011000001110000002000001    101
100000000011000001110111111111111    111 
11110111111111011100000000001011111
11110111111111011101010011111111101   
11000000110101011000000111111111111
1000000000000000110000001
100000000000000011010100111
11000001110101011111000001111
1111000111110101110111101001
11111111 11111111111111111111
